#####
#o#x#
#@@@#
#@  #
#   #
#####
